111111111111
100000000001
111110011111
111110011111
100000000001
100R00000R01
10000000000111
1000011N0011
111111111111
