NO ./texs/mario2.xpm
SO ./texs/mario.xpm
WE ./texs/mario.xpm
EA ./texs/redbrick.xpm

F 200,200,200
C 0,0,0

111111111111
 10000000001
111110011111
 111110011111
1000000000011111111
1000000000000000001 
1000000000011111111
1000011N00111
111111111111
