NO ./textures/north.xpm
SO ./textures/south.xpm
WE ./textures/west.xpm
EA ./textures/east.xpm

F 90,90,90
C 0,0,0

1111111111111
100000000001
111110011111
111110011111
100000000001
100000000001
10000000000111
100001100N11
111111111111
